blue: 0,A
red: 1,B
+++++++++
+b+++++1+
+ +++++B+
+       +
+A+++++ +
+0+++++a+
+++++++++
