blue: 0,A
red: 1,B
+++++++++++
+0b+++++a1+
+A +++++ B+
+  +++++  +
+         +
+++++++++++
