blue: 0,A
red: 1,B
green: 2,C
+++++++++++
+    c2   +
+A1     0B+
+         +
+   abC   +
+++++++++++
