blue: 0,A
red: 1,B
+++++++++++
+   1b    +
+         +
+0A      a+
+   B     +
+++++++++++
