blue: 0,A
red: 1,B
+++++++++++
+         +
+A1     0B+
+         +
+   ab    +
+++++++++++
