blue: 0,A
red: 1,B
green: 2,C
cyan: 3,D
+++++++++++++
+a  +++++  c+
+2C       A0+
+3D       B1+
+b  +++++  d+
+++++++++++++
