blue: 0,A
red: 1,B
+++++++++++
+   0     +
+         +
+1B      b+
+   Aa    +
+++++++++++
