blue: 0,A,C
red: 1,B,D
+++++++++
+   DCBA+ 
+ +     +
+d+ 1   +
+c+     +
+b+ 0   +
+a+     +
+++++++++