blue: 0,A
blue: 1,B
+++++++++++++++++++++++++
+0 B  a    b            + 
++++++++++++++++++      +
++++++++++++++++++ A    +
+++++++++++++++++++++1  +
+++++++++++++++++++++++++
