blue: 0,2,A
red: 1,B
++++++++++++++++
+   ++++++++  2+
+0  ++++++++  1+
+    Ab  aB    +
+   ++++++++   +
+   ++++++++  A+
++++++++++++++++
