blue: 0,A
red: 1,B,D
+++++++++
+  D  BA+ 
+ +     +
+ + 1   +
+ +     +
+b+ 0   +
+a+     +
+++++++++
