red: 0,A
green: 1,B
+++++++++++
+B       0+
+ AAAA    +
+ A  A    +
+ A  A    +
+ A bA   1+
+++++++++++
