blue: 0,A,C
red: 1,B
++++++++++
+   a    + 
+ ++++C 1+
+c++++B 0+
+ ++++A  +
+   b    +
++++++++++